10 10
..........
..#....#..
.......#..
..#.......
..#.o..#..
...#..#...
.......#..
.#.#..#...
.o.o.o.o#.
....#.....
9 0
0 8
kjasjhdiuo