10 10
..........
..........
...#.o#..
..#.##.#..
..........
....#.....
.......#..
......#...
..#.....##
......#...
9 0
0 1
